{
	"slice_width": [12, 14, 19, 15],
	"slice_locks": "1001",
	"transition_start": [10, 376],
	"transition_end": [970, 376],
	"tiles": {
		"0":  "111111111111111111111111111111111111111111111111111111111111",
		"1":  "111111111111111111111111111111111111111111111111111111111111",
		"2":  "111111111111111111111111111111111111111111111111111111111111",
		"3":  "111111111111111111111111111111111111111111111111111111111111",
		"4":  "111111111111111111111111111111111111111111111111111111111111",
		"5":  "111111111111111111111111111111111111111111111111111111111111",
		"6":  "000000000000000000000000000000000000000000000000000000000000",
		"7":  "000000000000000000000000000000000000000000000000000000000000",
		"8":  "000000000000000000000000000000000000000000000000000000000000",
		"9":  "000000000000000000000000000000000000000000000000000000000000",
		"10": "000000000000000000000000000000000000000000000000000000000000",
		"11": "000000000000000000000000000000000000000000000000000000000000",
		"12": "000111111111000000111111111000000111111111000000111111111000",
		"13": "000111111111000000111111111000000111111111000000111111111000",
		"14": "000000000000000000000000000000000000000000000000000000000000",
		"15": "000000000000000000000000000000000000000000000000000000000000",
		"16": "000000000000000000000000000000000000000000000000000000000000",
		"17": "000000000000000000000000000000000000000000000000000000000000",
		"18": "000111111111000000111111111000000111111111000000111111111000",
		"19": "000111111111000000111111111000000111111111000000111111111000",
		"20": "000000000000000000000000000000000000000000000000000000000000",
		"21": "000000000000000000000000000000000000000000000000000000000000",
		"22": "000000000000000000000000000000000000000000000000000000000000",
		"23": "000000000000000000000000000000000000000000000000000000000000",
		"24": "000000000000000000000000000000000000000000000000000000000000",
		"25": "000000000000000000000000000000000000000000000000000000000000",
		"26": "111111111111111111111111111111111111111111111111111111111111",
		"27": "111111111111111111111111111111111111111111111111111111111111",
		"28": "111111111111111111111111111111111111111111111111111111111111",
		"29": "111111111111111111111111111111111111111111111111111111111111",
		"30": "111111111111111111111111111111111111111111111111111111111111",
		"31": "111111111111111111111111111111111111111111111111111111111111",
		"32": "111111111111111111111111111111111111111111111111111111111111",
		"33": "111111111111111111111111111111111111111111111111111111111111"
	}
}